11111111111
1000P000001
10000000001
10000C00001
10C00000001
100C0000E01
11111111111
