11111111111
10000000001
10000000001
10000C00001
10C00000001
1P0C00000E1
11111111111
